Date,Location,Dead,Injured,Total,Description
"December 19, 2019",Moscow,3,5,8,"Moscow FSB headquarters shooting: Yevgeny Manyurov shot and killed 2 people and injured 5, after which he was shot dead by police."
"November 14, 2019","Blagoveshchensk, Amur Oblast",2,3,5,Amur College Shooting: A student at the Amur college of construction opened fire on other students and then shot himself.
"October 25, 2019","Gorny, Zabaykalsky Krai",8,2,10,Gorny shooting: A conscript soldier opened fire on his colleagues during a change of guards.
"October 17, 2018","Kerch, Republic of Crimea",21,70,91,Kerch Polytechnic College massacre: A student detonated a bomb and shot people and then shot himself.
"August 25, 2018","Yekaterinburg, Sverdlovsk Oblast",2,0,2,Alexey Alexandrov killed 2 young girls on Mount Uktus with a self-made shotgun.
"May 24, 2018","Bulgunnyakhtakh, Sakha Republic",6,0,6,Alexander Novikov killed 5 people.
"February 18, 2018","Kizlyar, Dagestan",6,4,10,"Kizlyar church shooting: Khalil Khalilov shot 5 people and wounded 4 others, after which he was killed by the police."
"October 23, 2017","Shelkovskaya, Chechnya",5,0,5,Marat Hajiyev shot 4 soldiers after which he was shot by other soldiers.
"September 29, 2017","Belogorsk, Amur Oblast",3,2,5,Hasan Abdulakhadov shot and killed 3 soldiers and wounded 2 others and was shot the next day.
"June 10–11, 2017","Kratovo, Moscow Oblast",6,6,12,Mass murder in Kratovo: Igor Zenkov killed 5 people and wounded 6 and then shot himself.
"June 4, 2017","Redkino, Konakovsky District, Tver Oblast",9,0,9,Mass murder in Redkino: Sergey Egorov killed 9 people.
"April 21, 2017","Khabarovsk, Khabarovsk Krai",4,1,5,"Anton Vyacheslavovich Konev shot and killed 2 people in the FSB reception room and wounded another one and was killed by return fire.
Before the attack, he shot an instructor in a shooting range."
"December 27, 2016",Moscow,1,5,6,45-year-old K. Lunkov injured five people with a hunting rifle before committing suicide.
"December 15, 2016","Olsha, Smolensk Oblast",5,3,8,Georgy Borisovich Yudaev shot 4 people and wounded 3 and then shot himself.
"October 30, 2016","Yekaterinburg, Sverdlovsk Oblast",0,5,5,Man injured five people at a nightclub
"September 3, 2016","Yekaterinburg, Sverdlovsk Oblast",2,7,9,38-year-old Oleg Shishova shot and killed two people and injured seven others with a rifle
"August 10, 2016","Maltsevo, Mordovia",3,0,3,Grigory Gryaznov shot 3 people.
"July 26, 2016","Magas, Ingushetia",1,4,5,"Domestic dispute escalated into a shooting, killing the local chief of police, Isa Yevloyev, and injuring four others"
"June 5, 2016","Mytischi, Moscow Oblast",0,4,4,Four men were injured
"May 8, 2016","Chelokhovo, Moscow Oblast",5,0,5,Mass murder in Yegoryevsk: Ilya Aseev killed 5 people and was arrested the next day.
"March 27, 2016","Yakovlevskoye, Vologda Oblast",1,3,4,55-year-old Alexei Bychkov shot and killed one person and wounded three others
"February 22, 2016","Tyumen, Tyumen Oblast",0,4,4,A group of friends opened fire at a nightclub injuring four people
"January 31, 2016","Shlisselburg, Leningrad Oblast",2,3,5,Two men were killed and three were wounded during a dispute
"January 2, 2016","Miass, Chelyabinsk Oblast",4,1,5,Alexander Grigoriev shot and killed four people and wounded another with a hunting rifle
"October 19, 2015","Krasnogorsky District, Moscow Oblast",4,0,4,"ru:?????????, ?????? ??????????: Amiran Georgadze shot 4 people and shot himself on October 20."
"September 26, 2015","Simferopol, Republic of Crimea",2,2,4,"ru:??????, ????? ????-?????????: Bekir Nebiev shot 2 people and wounded 2 more and shot later."
"August 26, 2015",Kostroma Oblast,6,1,7,Pavel Bakhtin shot five soldiers and wounded another and then shot himself.
"January 27, 2015","Blagoveshchensk, Amur Oblast",4,0,4,Vladimir Levkin shot 3 people and then shot himself.
"February 9, 2014","Yuzhno-Sakhalinsk, Sakhalin Oblast",2,6,8,Shooting in the Resurrection Cathedral of Yuzhno-Sakhalinsk: Stepan Komarov shot 2 people and injured 6 others.
"February 3, 2014",Moscow,2,1,3,2014 Moscow school shooting: Sergey Gordeev shot 2 people and wounded 1 other.
"April 22, 2013","Belgorod, Belgorod Oblast",6,0,6,2013 Belgorod shooting: Sergey Pomazun shot 6 people and was arrested the next day.
"November 7, 2012",Moscow,6,1,7,2012 Moscow shooting: Dmitry Vinogradov shot 6 people and wounded one other.
"August 28, 2012","Belidzhi, Dagestan",8,6,14,"Ramzan Aliyev shot 7 soldiers and wounded 6 others, after which he was shot dead by soldiers."
15/10/2022,"Soloti, Belgorod Oblast",13,15,28,"Soloti military training ground shooting: 2 conscripts from Tajikistan committed friendly fire, killing 11 people before being killed by return fire."
26/09/2022,"Izhevsk, Udmurtia",18,24,42,Izhevsk school shooting: Artem Kazantsev opened fire at his former school before committing suicide.
15/07/2022,"Novoshakhtinsk, Rostov Oblast",4,1,5,Denys Mashonsky shot four people and wounded another.
26/04/2022,"Veshkayma, Ulyanovsk Oblast",5,1,6,Veshkayma kindergarten shooting: Ruslan Rushanovich Akhtyamov fatally shot four people and wounded a fifth before committing suicide.
07/12/2021,Moscow,2,4,6,"Moscow Multifunctional Center shooting: 45-year-old male shot and killed two people and wounded four others, reportedly after being told to put on a face mask."
20/09/2021,"Perm, Perm Krai",6,48,54,Perm State University shooting: Timur Bekmansurov fatally shot six people at a university in the city of Perm before being apprehended by police.
27/06/2021,"Biser, Perm Krai",3,1,4,Sergei Shinkevich fatally shot three people and wounded one.
11/05/2021,"Kazan, Tatarstan",9,23,32,Kazan school shooting: Ilnaz Galyaviev killed seven students and two teachers in Gymnasium No. 175 and injured 23 others before being arrested.
09/11/2020,"Voronezh Malshevo (air base), Voronezh Oblast",3,1,4,Anton Makarov shot 3 people to death and wounded 1 more before being arrested.
07/11/2020,"Yekaterinburg, Sverdlovsk Oblast",4,1,5,Dmitry Zakharov killed 3 people and wounded another before shooting himself.
12/10/2020,"Bolsheorlovskoe, Nizhny Novgorod Oblast",5,2,7,Daniil Monakhov killed 4 people and wounded 2 more before shooting himself.
18/06/2020,Moscow,4,0,4,Sevastyan Putintsev shot 3 people to death before shooting himself.
04/04/2020,"Yelatma, Ryazan Oblast",5,0,5,Anton Franchikov shot 5 people to death.
15/02/2020,"Kaliningrad, Kaliningrad Oblast",4,1,5,Fazil Bahramov fatally shot 2 people and wounded another before shooting himself.
"October 8, 2009",Moscow,0,3,3,29-year-old man shot and injured three people during a road rage incident
"April 27, 2009",Moscow,2,7,9,ru:???? ????????: Denis Evsyukov shot and killed 2 people and wounded 7 others.
"April 13, 2009","Borzoy, Chechnya",3,1,4,Unknown soldier shot 3 soldiers and wounded himself.
"Juli 7, 2008",Primorsky Krai,4,0,4,An unidentified soldier shot 3 soldiers and killed himself.
"December 6, 2007","Botlih, Dagestan",1,2,3,Vladimir Buldakhin shot 1 soldier and wounded 2 others.
"April 23, 2007","Balashikha, Moscow Oblast",4,0,4,2007 Balashikha shooting: Alexander Levin shot 4 people.
"April 12–17, 2007","Sochi, Krasnodar Krai",6,1,7,Sochi bombings#Perpetrators: Ilya Galkin shot 6 people and wounded another.
"February 6, 2007",Astrakhan Oblast,3,1,4,Pyotr Babin shot 2 soldiers and wounded 1 more and then shot himself.
"March 15, 2005",Chita Oblast,7,1,8,4 soldiers killed 6 people.
"August 30, 2004",Dagestan,2,1,3,Vyacheslav Ustalov shot 2 soldiers and wounded 1.
"March 3, 2004","Tuskharoy, Chechnya",3,0,3,Evgeny Demyanov shot 3 people.
"February 20, 2003",Krasnoyarsk Krai,5,0,5,Sergey Khanov shot 4 soldiers and then shot himself.
"November 29, 2002",Karachay-Cherkessia,5,6,11,Denis Soloviev shot five soldiers and wounded 6 others.
"August 25, 2002","Yaroslavsky, Primorsky Krai",5,10,15,Yaroslavsky shooting: Sergey Semidovsky shot 5 people and injured 10 others.
"August 23, 2002",Ingushetia,8,0,8,Oleg Khismatulin and Nikolai Bozhkov shot 8 soldiers.
"April 11, 2002","Makhachkala, Dagestan",2,2,4,Turar Abugaliev shot and killed 2 soldiers and wounded 1 and then wounded himself.
"February 3–5, 2002",Tatarstan,11,2,13,Almaz Shageev and Mikhail Sukhorukov killed 9 people and injured 2 others. Shageev killed Sukhorukov and then killed himself.
"January 31, 2002","Uelen, Chukotka Autonomous Okrug",4,0,4,Andrei Rastegaev shot 4 soldiers.
"August 6, 2001","Abakan, Khakassia",4,0,4,Denis Pertsev shot 4 soldiers.
"Juli 8, 2001","Kamensk-Shakhtinsky, Rostov Oblast",6,1,7,Denis Smyshlyaev and Yevgeny Samoilov shot dead 6 soldiers and wounded 1.
"September 30, 2000","Solikamsk, Perm Krai",2,6,8,Alexey Skorobogatykh shot two soldiers and wounded 6 others.
"April 7, 2000","Zenzevatka, Volgograd Oblast",8,0,8,Oleg Dolzhenko shot 8 soldiers.
08/10/1999,"Mekenskaya, Chechnya",35,20,55,Ahmed Ibragimov shot 35 people and wounded more than 20 others in the Mikenskaya shootings.
10/09/1998,"Severomorsk, Murmansk Oblast",9,2,11,Russian submarine Vepr (K-157): Alexander Kuzminykh shot dead 8 soldiers and wounded 2 others then shot himself.
26/01/1998,"Pobedino, Sakhalin Oblast",7,1,8,Oleg Naumov shot 7 soldiers and wounded 1.
29/05/1997,"Gusinoozyorsk, Buryatia",6,0,6,Yevgeny Gorbunov shot 6 soldiers.
09/03/1997,"Kamyshin, Volgograd Oblast",6,2,8,Mass murder at the Kamyshin military school: Sergey Lepnev shot 6 colleagues and wounded 2.
04/01/1997,"Perm, Perm Krai",4,4,8,Oleg Lokhmatov shot 3 soldiers and 1 civilian and wounded 3 civilians.
10/10/1996,"Smirnykh, Sakhalin Oblast",4,0,4,Sergey Khrushch and Konstantin Krylov shot four soldiers.
26/02/1996,"Kuzovlevo, Tomsk Oblast",4,0,4,Yuri Dovgan and Alexander Kochetkov killed two soldiers and were killed by another soldier.
14/11/1995,Zabaykalsky Krai,2,3,5,Valery Sakharov killed 2 and wounded 3 other soldiers.
30/07/1995,"Popov Island, Primorsky Krai",5,6,11,Vyacheslav Bugakov shot five soldiers and wounded 6 others.
08/03/1994,"Tanfiliev Island, Sakhalin Oblast",6,3,9,Dmitry Belkov and Andrey Bogdashin shot dead 6 soldiers and wounded 3.
26/04/1992,"Kazan, Tatarstan",9,1,10,Andrey Shpagonov killed nine people and wounded one other while trying to steal firearms during a robbery. He was sentenced to death and executed in 1995.
26/03/1992,"Kyakhta, Buryatia",8,2,10,An unknown soldier killed 8 soldiers and wounded 2 others.
